NO	textures/north.xpm									
SO textures/south.xpm
WE textures/west.xpm
EA textures/east.xpm
F 255,  255  ,0
C 0,0,0,


        11111111111111111 1111111111111111111111
11111111000000000000100001000000000000001
1000000100000000000000000000000000000001
1001111100000000000000000000000000000001
1000000000000000000000000000000000000001
1000000111100000000000000000000000000001
1000000111100000000000000000000000000001
100000011110000000000000000000000000001
1000000000011000000000000000000000000001
10000000000111000000011110000000000000001
10000011110111010000010000000000000000001
1000001000011001000010001000000000000001
1000001000011100111110010000000000000001
1000001000011110000000010000000000000001
1000001000000001111111100111110000000011111
10000000000000010000000001   1E0000000000001
111111111111111 111111111111111111111111111111




